000000100000000
000000100000000
000000100000000
000000000000000
000000000000000
000000000000000
000000000000000
000000000000000
000000000000000
000000000000000
000001000000000
000000100000000
000000010000000
000000010000000
111000010000000
000000011000111
000000010000000
000000000000000
000000000000000
000000000000000
