000000000000000
000011110000000
000000000000000
000000000000000
000000111100000
000000000000000
000000111100000
000000000000000
000000000000000
000000000000000
000001111000000
000000000000000
000000000000000
000000001111000
000000000000000
000111100000000
000000000000000
000000000000000
000000000000000
000000000000000
