000000000000000
000000000000000
000000000000000
000000000000000
011111111110000
000000000000000
000000000000000
000000000000000
111111111000000
000000000000000
000000000000000
000000000000000
000111111111000
000000000000000
000000000000000
111111000000000
000000000000000
000000000000000
000000000000000
000000000111111