000000000000000
000000000000000
000000000000000
000011111000000
000010001000000
000010001000000
000010001000000
000010001000000
000000000000000
000000000000000
000000000000000
000000000000000
000001111111000
000000000001000
000000000001000
000000000001000
000000011111000
000000000000000
000000000000000
000000000000000