000000000000000
000000000000000
000000000000000
000010000111000
000001000001000
000010000001000
000000000001000
000000000001000
000001000000000
000001000000000
000010000000000
000000000000000
000000000100000
000100000010000
000100000100000
000100000000000
000111100000000
000000000000000
000000000000000
000000000000000
